1111111111111
100000P000001
10111100001E1
1C1000CC001C1
1111111111111
